11111111111111111111111
1P0110000000C0000000011
1C0001110000E000C000111     
10000000C00000111100001
11111111111111111111111