11111111111111111111111
1P1110000000C0000000011
1C0001110000E00000C0001
10000000C00000111100001
11111111111111111111111